0 0 0 0 0 0 0 0
0 1 1 1 1 1 1 0
0 2 3 4 7 1 0 2 
0 2 1 5 2 5 1 0
0 1 1 1 1 1 1 1
2 2 2 3 4 7 9 1
0 1 2 5 1 2 3 1